1111111111111
10110100000C1
1000011111001
1P0011E000C01
1111111111111
