111111
1P0011
1C0011
1E0011
111111
