1111111111111
10110000000C1
1000000000001
1P0011E000C01
1111111111111
